000000000000000000000000000000
000000000000000000000000000000
000000000000000000000000000000
000000000000000000000000000000
000000000000000000000000000000
000000000000000000000000000000
000000000000000000000000000000
000000000000000000000000000000
000000000000000000000000000000
000000000000000000000000000000
000000000000000000000000000000
000000000000000000000000000000
000000000000000000000000000011
000000000000000000000000001000
000000000000000000000000000000
000000000000000000000000100000
000000000011000000000000000000
000000011000000000000010000000
000111000000000110000000000000
111222222222222221111222222222
